XXXXXXXXXXXXXXXXX
XXXXXX0000XRXXXXX
XXXXXX0RX000000XX
XXRXXX0XXXXXXX000
0X00000XXXXXXXX00
000XXXRXXXXXXXXXX
XXXXXXXXXXXXXXXXX
XXXXXXXXXXXXXXXXX
XXXXXXXXXXXXXXXXX
XXXXXXXXXXXXXXXXX
XXXXXXXXXXXXXXXXX
XXXXXXXXXXXXXXXXX