XXXXXXXXXXXXXXXXX
XXXXXX0000XXXXXXX
XXXXXX0XX000000XX
XXXXXX0XXXXXXX000
XXXXXX0XXXXXXXXXX
XXXXXX0XXXXXXXXXX
XXX0000XXXXXXXXXX
0000XXXXXXXXXXXXX
XXXXXXXXXXXXXXXXX
XXXXXXXXXXXXXXXXX